.,.,.,.,.,.
.,.,W,.,P,.
.,.,.,.,.,.
.,.,A,.,P,.
.,.,G,.,.,.
.,.,.,.,.,.
