.,.,.,.,.,.
.,.,W,G,P,.
.,.,.,.,.,.
.,.,A,.,P,.
.,.,.,.,.,.
.,.,.,.,.,.
